30222222000
01212121210
00200020222
01012121212
22222022202
21012101212
20222020022
21212101010
00202002222
21012101010
22220222003